



           NO                    ./src/texture/207.png


    WE ./src/texture/215.png                  


C 0   ,0,   0

                        SO ./src/texture/214.png               

   F     0 ,    0  ,0    


EA ./src/texture/216.png

111111111111111111111111
100000000000000000000001
100000000000000000000001
100000000000000000000001
100000000000000000000001
100000000000000000000001
100000000000000000N00001
111111111111111111111111