    NO      ./src/texture/207.png     
SO ./src/texture/214.png
WE ./src/texture/215.png
EA ./src/texture/216.png

      F      220     ,     100   ,    0       
C 225,30,0

           1111111111111111111
           1S00000000000100001
           1000010000000100001
           1000010000000000001
11111111111100111111111111100111111111111
10000000000000000000000000000000000000001
10000000000000000000000000000000000000001
10000000000000000000000011111111111111001
10001010100000000000000010000000000001001
10000000000000000000000010000000000000001
10001000100000000000000010000000000000001
10000000000000000000000010000000000001111
10001010100000000000000011111110011111111
10000000000000000000000000000000000000001
10000000000000000000000000000000000000001
10000000000000000000000010000000000000001
10000000000000000000000000000000000000001
10000000000000000000000000000000000000001
11111111111111111111111111111111111111111
