NO ./src/texture/207.png
SO ./src/texture/214.png
WE ./src/texture/215.png
EA ./src/texture/216.png

F 220,100,0
C 225,30,0

11111111111111111111111111111111111111111
10000000000000000000000000000000000000001
10010100000000000000000000000000000000001
10001000000000000000000000000000000000001
10000000000000000000000000000000000000001
10000000000000000000000000000000000000001
10000000000000000000000000000000000000001
10000000000000000000000000000000000000001
10000000000000000000000000000000000000001
10000000000000000000000000000000000000001
10000000000000000000000000000000000000001
10000000000000000000000000000000000000001
10000000000000000000000000000000000000001
10000000000000000000000000000000000000001
11111111111111111111111111111111111111111
